111111111111111
100000010000001
101110111110101
100010000010001
100010001000001
10001011100E001
100010000000001
100111100011001
100T00000X01001
100000011110001
101000000000101
100P00001111111
1000T000100C111
100000000000001
111111111111111