111111111111111
100000010000001
101110111110101
100010000010001
10001C001001001
10001011101E101
100010000C00001
100111100011001
100T00C00X01001
100000011110001
101000000000101
100P0000C100001
1000T000100C001
100110010100001
111111111111111
